game_id,posteam,RushingYards,PassingYards,TotalYards,home_score,away_score,Winner,Win,Q4_RushingYards,Q4_PassingYards,Q4_TotalYards
2023_01_ARI_WAS,ARI,96,132,228,20,16,WAS,0,18,19,37
2023_01_ARI_WAS,WAS,92,202,294,20,16,WAS,1,41,10,51
2023_01_BUF_NYJ,BUF,97,236,333,22,16,NYJ,0,19,64,83
2023_01_BUF_NYJ,NYJ,172,140,312,22,16,NYJ,1,30,41,71
2023_01_CAR_ATL,ATL,130,115,245,24,10,ATL,1,16,62,78
2023_01_CAR_ATL,CAR,154,146,300,24,10,ATL,0,23,41,64
2023_01_CIN_CLE,CIN,75,82,157,24,3,CLE,0,1,11,12
2023_01_CIN_CLE,CLE,206,154,360,24,3,CLE,1,37,32,69
2023_01_DAL_NYG,DAL,122,143,265,0,40,DAL,1,32,26,58
2023_01_DAL_NYG,NYG,108,110,218,0,40,DAL,0,9,51,60
2023_01_DET_KC,DET,118,253,371,20,21,DET,1,54,59,113
2023_01_DET_KC,KC,90,226,316,20,21,DET,0,12,13,25
2023_01_GB_CHI,CHI,122,216,338,20,38,GB,0,41,72,113
2023_01_GB_CHI,GB,92,245,337,20,38,GB,1,32,71,103
2023_01_HOU_BAL,BAL,110,169,279,25,9,BAL,1,14,37,51
2023_01_HOU_BAL,HOU,72,242,314,25,9,BAL,0,17,84,101
2023_01_JAX_IND,IND,65,223,288,21,31,JAX,0,12,59,71
2023_01_JAX_IND,JAX,105,241,346,21,31,JAX,1,61,38,99
2023_01_LA_SEA,LA,92,334,426,13,30,LA,1,32,78,110
2023_01_LA_SEA,SEA,85,112,197,13,30,LA,0,9,10,19
2023_01_LV_DEN,DEN,94,177,271,16,17,LV,0,16,25,41
2023_01_LV_DEN,LV,61,200,261,16,17,LV,1,14,72,86
2023_01_MIA_LAC,LAC,233,229,462,34,36,MIA,0,44,68,112
2023_01_MIA_LAC,MIA,70,466,536,34,36,MIA,1,2,124,126
2023_01_PHI_NE,NE,76,316,392,20,25,PHI,0,23,139,162
2023_01_PHI_NE,PHI,97,170,267,20,25,PHI,1,18,66,84
2023_01_SF_PIT,PIT,41,232,273,7,30,SF,0,9,121,130
2023_01_SF_PIT,SF,188,220,408,7,30,SF,1,35,22,57
2023_01_TB_MIN,MIN,41,344,385,17,20,TB,0,1,10,11
2023_01_TB_MIN,TB,73,173,246,17,20,TB,1,25,52,77
2023_01_TEN_NO,NO,69,305,374,16,15,NO,1,25,79,104
2023_01_TEN_NO,TEN,104,198,302,16,15,NO,0,10,90,100
2023_02_BAL_CIN,BAL,178,237,415,24,27,BAL,1,57,43,100
2023_02_BAL_CIN,CIN,66,222,288,24,27,BAL,0,17,74,91
2023_02_CHI_TB,CHI,67,211,278,27,17,TB,0,6,94,100
2023_02_CHI_TB,TB,120,317,437,27,17,TB,1,16,42,58
2023_02_CLE_PIT,CLE,198,235,433,26,22,PIT,0,32,100,132
2023_02_CLE_PIT,PIT,55,222,277,26,22,PIT,1,4,0,4
2023_02_GB_ATL,ATL,211,237,448,25,24,ATL,1,47,119,166
2023_02_GB_ATL,GB,84,151,235,25,24,ATL,0,11,0,11
2023_02_IND_HOU,HOU,52,384,436,20,31,IND,0,2,190,192
2023_02_IND_HOU,IND,126,227,353,20,31,IND,1,26,11,37
2023_02_KC_JAX,JAX,74,215,289,9,17,KC,0,15,43,58
2023_02_KC_JAX,KC,100,305,405,9,17,KC,1,52,90,142
2023_02_LAC_TEN,LAC,61,305,366,27,24,TEN,0,11,94,105
2023_02_LAC_TEN,TEN,141,246,387,27,24,TEN,1,15,74,89
2023_02_LV_BUF,BUF,183,274,457,38,10,BUF,1,67,65,132
2023_02_LV_BUF,LV,55,185,240,38,10,BUF,0,23,34,57
2023_02_MIA_NE,MIA,145,249,394,17,24,MIA,1,74,8,82
2023_02_MIA_NE,NE,88,231,319,17,24,MIA,0,46,103,149
2023_02_MIN_PHI,MIN,28,364,392,34,28,PHI,0,13,153,166
2023_02_MIN_PHI,PHI,259,193,452,34,28,PHI,1,72,20,92
2023_02_NO_CAR,CAR,100,153,253,17,20,NO,0,56,69,125
2023_02_NO_CAR,NO,134,236,370,17,20,NO,1,41,53,94
2023_02_NYG_ARI,ARI,151,228,379,28,31,NYG,0,5,27,32
2023_02_NYG_ARI,NYG,127,321,448,28,31,NYG,1,66,149,215
2023_02_NYJ_DAL,DAL,134,255,389,30,10,DAL,1,21,31,52
2023_02_NYJ_DAL,NYJ,64,170,234,30,10,DAL,0,0,54,54
2023_02_SEA_DET,DET,102,323,425,31,37,SEA,0,26,81,107
2023_02_SEA_DET,SEA,82,328,410,31,37,SEA,1,24,34,58
2023_02_SF_LA,LA,89,307,396,23,30,SF,0,17,102,119
2023_02_SF_LA,SF,159,206,365,23,30,SF,1,45,54,99
2023_02_WAS_DEN,DEN,122,308,430,33,35,WAS,0,33,122,155
2023_02_WAS_DEN,WAS,122,299,421,33,35,WAS,1,29,81,110
2023_03_ATL_DET,ATL,44,201,245,20,6,DET,0,5,81,86
2023_03_ATL_DET,DET,115,243,358,20,6,DET,1,53,22,75
2023_03_BUF_WAS,BUF,168,218,386,3,37,BUF,1,75,19,94
2023_03_BUF_WAS,WAS,105,170,275,3,37,BUF,0,0,58,58
2023_03_CAR_SEA,CAR,44,361,405,37,27,SEA,0,11,94,105
2023_03_CAR_SEA,SEA,146,296,442,37,27,SEA,1,54,39,93
2023_03_CHI_KC,CHI,116,99,215,41,10,KC,0,22,57,79
2023_03_CHI_KC,KC,153,303,456,41,10,KC,1,44,31,75
2023_03_DAL_ARI,ARI,222,189,411,28,16,ARI,1,29,76,105
2023_03_DAL_ARI,DAL,185,249,434,28,16,ARI,0,45,61,106
2023_03_DEN_MIA,DEN,69,306,375,70,20,MIA,0,21,57,78
2023_03_DEN_MIA,MIA,350,376,726,70,20,MIA,1,140,77,217
2023_03_HOU_JAX,HOU,86,280,366,17,37,HOU,1,41,68,109
2023_03_HOU_JAX,JAX,116,288,404,17,37,HOU,0,7,121,128
2023_03_IND_BAL,BAL,186,202,388,19,22,IND,0,49,62,111
2023_03_IND_BAL,IND,139,227,366,19,22,IND,1,12,52,64
2023_03_LAC_MIN,LAC,30,454,484,24,28,LAC,1,1,105,106
2023_03_LAC_MIN,MIN,130,367,497,24,28,LAC,0,23,136,159
2023_03_LA_CIN,CIN,67,259,326,19,16,CIN,1,11,24,35
2023_03_LA_CIN,LA,71,269,340,19,16,CIN,0,9,65,74
2023_03_NE_NYJ,NE,157,201,358,10,15,NE,1,51,20,71
2023_03_NE_NYJ,NYJ,38,157,195,10,15,NE,0,6,110,116
2023_03_NO_GB,GB,95,259,354,18,17,GB,1,32,104,136
2023_03_NO_GB,NO,77,204,281,18,17,GB,0,9,96,105
2023_03_NYG_SF,NYG,29,137,166,30,12,SF,0,4,19,23
2023_03_NYG_SF,SF,141,310,451,30,12,SF,1,30,58,88
2023_03_PHI_TB,PHI,201,277,478,11,25,PHI,1,27,45,72
2023_03_PHI_TB,TB,41,146,187,11,25,PHI,0,16,59,75
2023_03_PIT_LV,LV,69,324,393,18,23,PIT,0,23,111,134
2023_03_PIT_LV,PIT,105,235,340,18,23,PIT,1,9,11,20
2023_03_TEN_CLE,CLE,78,289,367,27,3,CLE,1,31,50,81
2023_03_TEN_CLE,TEN,26,104,130,27,3,CLE,0,8,8,16
2023_04_ARI_SF,ARI,105,265,370,35,16,SF,0,14,96,110
2023_04_ARI_SF,SF,124,283,407,35,16,SF,1,49,35,84
2023_04_ATL_JAX,ATL,127,191,318,23,7,JAX,0,18,79,97
2023_04_ATL_JAX,JAX,105,207,312,23,7,JAX,1,38,30,68
2023_04_BAL_CLE,BAL,131,186,317,3,28,BAL,1,8,32,40
2023_04_BAL_CLE,CLE,93,121,214,3,28,BAL,0,71,11,82
2023_04_CIN_TEN,CIN,72,165,237,27,3,TEN,0,19,52,71
2023_04_CIN_TEN,TEN,173,242,415,27,3,TEN,1,45,13,58
2023_04_DEN_CHI,CHI,171,335,506,28,31,DEN,0,95,50,145
2023_04_DEN_CHI,DEN,97,223,320,28,31,DEN,1,11,106,117
2023_04_DET_GB,DET,211,210,421,20,34,DET,1,65,45,110
2023_04_DET_GB,GB,27,246,273,20,34,DET,0,15,75,90
2023_04_KC_NYJ,KC,204,203,407,20,23,KC,1,59,41,100
2023_04_KC_NYJ,NYJ,108,245,353,20,23,KC,0,1,25,26
2023_04_LA_IND,IND,133,200,333,23,29,LA,0,21,118,139
2023_04_LA_IND,LA,164,319,483,23,29,LA,1,15,42,57
2023_04_LV_LAC,LAC,155,167,322,24,17,LAC,1,7,54,61
2023_04_LV_LAC,LV,76,238,314,24,17,LAC,0,23,89,112
2023_04_MIA_BUF,BUF,104,320,424,48,20,BUF,1,31,2,33
2023_04_MIA_BUF,MIA,142,282,424,48,20,BUF,0,78,68,146
2023_04_MIN_CAR,CAR,83,204,287,13,21,MIN,0,39,68,107
2023_04_MIN_CAR,MIN,135,139,274,13,21,MIN,1,15,0,15
2023_04_NE_DAL,DAL,124,281,405,38,3,DAL,1,53,44,97
2023_04_NE_DAL,NE,53,207,260,38,3,DAL,0,9,46,55
2023_04_PIT_HOU,HOU,139,312,451,30,6,HOU,1,33,93,126
2023_04_PIT_HOU,PIT,114,132,246,30,6,HOU,0,21,18,39
2023_04_SEA_NYG,NYG,112,203,315,3,24,SEA,0,29,51,80
2023_04_SEA_NYG,SEA,121,173,294,3,24,SEA,1,49,3,52
2023_04_TB_NO,NO,70,140,210,9,26,TB,0,6,48,54
2023_04_TB_NO,TB,114,246,360,9,26,TB,1,27,70,97
2023_04_WAS_PHI,PHI,104,319,423,34,31,PHI,1,32,49,81
2023_04_WAS_PHI,WAS,107,290,397,34,31,PHI,0,58,106,164
2023_05_BAL_PIT,BAL,125,236,361,17,10,PIT,0,13,33,46
2023_05_BAL_PIT,PIT,87,224,311,17,10,PIT,1,18,104,122
2023_05_CAR_DET,CAR,99,247,346,42,24,DET,0,34,101,135
2023_05_CAR_DET,DET,159,236,395,42,24,DET,1,51,27,78
2023_05_CHI_WAS,CHI,178,282,460,20,40,CHI,1,26,56,82
2023_05_CHI_WAS,WAS,29,388,417,20,40,CHI,0,6,183,189
2023_05_CIN_ARI,ARI,142,166,308,20,34,CIN,0,2,44,46
2023_05_CIN_ARI,CIN,93,317,410,20,34,CIN,1,12,73,85
2023_05_DAL_SF,DAL,57,161,218,42,10,SF,0,23,34,57
2023_05_DAL_SF,SF,170,253,423,42,10,SF,1,56,2,58
2023_05_GB_LV,GB,110,182,292,17,13,LV,0,20,46,66
2023_05_GB_LV,LV,96,208,304,17,13,LV,1,18,22,40
2023_05_HOU_ATL,ATL,96,351,447,21,19,ATL,1,30,118,148
2023_05_HOU_ATL,HOU,64,249,313,21,19,ATL,0,37,46,83
2023_05_JAX_BUF,BUF,29,359,388,20,25,JAX,0,6,181,187
2023_05_JAX_BUF,JAX,196,315,511,20,25,JAX,1,87,62,149
2023_05_KC_MIN,KC,67,281,348,20,27,KC,1,21,17,38
2023_05_KC_MIN,MIN,70,284,354,20,27,KC,0,6,131,137
2023_05_NO_NE,NE,45,132,177,0,34,NO,0,16,22,38
2023_05_NO_NE,NO,136,183,319,0,34,NO,1,20,20,40
2023_05_NYG_MIA,MIA,222,308,530,31,16,MIA,1,11,12,23
2023_05_NYG_MIA,NYG,85,205,290,31,16,MIA,0,16,93,109
2023_05_NYJ_DEN,DEN,139,196,335,21,31,NYJ,0,7,130,137
2023_05_NYJ_DEN,NYJ,234,199,433,21,31,NYJ,1,35,75,110
2023_05_PHI_LA,LA,54,222,276,14,23,PHI,0,11,55,66
2023_05_PHI_LA,PHI,159,303,462,14,23,PHI,1,55,47,102
2023_05_TEN_IND,IND,193,253,446,23,16,IND,1,37,58,95
2023_05_TEN_IND,TEN,89,264,353,23,16,IND,0,27,58,85
2023_06_ARI_LA,ARI,130,235,365,26,9,LA,0,12,118,130
2023_06_ARI_LA,LA,179,226,405,26,9,LA,1,67,40,107
2023_06_BAL_TEN,BAL,139,223,362,16,24,BAL,1,19,53,72
2023_06_BAL_TEN,TEN,129,150,279,16,24,BAL,0,18,74,92
2023_06_CAR_MIA,CAR,108,224,332,42,21,MIA,0,7,39,46
2023_06_CAR_MIA,MIA,162,262,424,42,21,MIA,1,54,11,65
2023_06_DAL_LAC,DAL,96,272,368,17,20,DAL,1,35,111,146
2023_06_DAL_LAC,LAC,53,227,280,17,20,DAL,0,1,26,27
2023_06_DEN_KC,DEN,115,95,210,19,8,KC,0,16,38,54
2023_06_DEN_KC,KC,96,306,402,19,8,KC,1,8,76,84
2023_06_DET_TB,DET,40,353,393,6,20,DET,1,11,81,92
2023_06_DET_TB,TB,46,206,252,6,20,DET,0,0,78,78
2023_06_IND_JAX,IND,44,329,373,37,20,JAX,0,5,114,119
2023_06_IND_JAX,JAX,85,181,266,37,20,JAX,1,-2,21,19
2023_06_MIN_CHI,CHI,162,141,303,13,19,MIN,0,45,71,116
2023_06_MIN_CHI,MIN,46,181,227,13,19,MIN,1,8,13,21
2023_06_NE_LV,LV,84,264,348,21,17,LV,1,9,12,21
2023_06_NE_LV,NE,83,200,283,21,17,LV,0,20,69,89
2023_06_NO_HOU,HOU,120,199,319,20,13,HOU,1,21,17,38
2023_06_NO_HOU,NO,89,357,446,20,13,HOU,0,37,110,147
2023_06_NYG_BUF,BUF,128,169,297,14,9,BUF,1,25,49,74
2023_06_NYG_BUF,NYG,132,200,332,14,9,BUF,0,76,59,135
2023_06_PHI_NYJ,NYJ,89,186,275,20,14,NYJ,1,7,19,26
2023_06_PHI_NYJ,PHI,80,280,360,20,14,NYJ,0,52,54,106
2023_06_SEA_CIN,CIN,46,185,231,17,13,CIN,1,6,16,22
2023_06_SEA_CIN,SEA,87,326,413,17,13,CIN,0,22,129,151
2023_06_SF_CLE,CLE,160,192,352,19,17,CLE,1,62,37,99
2023_06_SF_CLE,SF,108,125,233,19,17,CLE,0,11,52,63
2023_06_WAS_ATL,ATL,106,307,413,16,24,WAS,0,34,106,140
2023_06_WAS_ATL,WAS,72,151,223,16,24,WAS,1,4,18,22
2023_07_ARI_SEA,ARI,127,150,277,20,10,SEA,0,17,72,89
2023_07_ARI_SEA,SEA,115,219,334,20,10,SEA,1,22,12,34
2023_07_ATL_TB,ATL,156,250,406,13,16,ATL,1,61,87,148
2023_07_ATL_TB,TB,73,275,348,13,16,ATL,0,37,71,108
2023_07_BUF_NE,BUF,81,265,346,29,25,NE,0,17,85,102
2023_07_BUF_NE,NE,96,272,368,29,25,NE,1,17,127,144
2023_07_CLE_IND,CLE,150,183,333,38,39,CLE,1,20,95,115
2023_07_CLE_IND,IND,168,305,473,38,39,CLE,0,12,81,93
2023_07_DET_BAL,BAL,146,357,503,38,6,BAL,1,30,14,44
2023_07_DET_BAL,DET,84,284,368,38,6,BAL,0,36,86,122
2023_07_GB_DEN,DEN,145,194,339,19,17,DEN,1,19,28,47
2023_07_GB_DEN,GB,137,194,331,19,17,DEN,0,35,62,97
2023_07_JAX_NO,JAX,113,217,330,24,31,JAX,1,41,49,90
2023_07_JAX_NO,NO,112,301,413,24,31,JAX,0,20,114,134
2023_07_LAC_KC,KC,68,424,492,31,17,KC,1,12,59,71
2023_07_LAC_KC,LAC,139,259,398,31,17,KC,0,6,56,62
2023_07_LV_CHI,CHI,173,162,335,30,12,CHI,1,45,13,58
2023_07_LV_CHI,LV,39,204,243,30,12,CHI,0,-5,83,78
2023_07_MIA_PHI,MIA,45,216,261,31,17,PHI,0,0,44,44
2023_07_MIA_PHI,PHI,99,279,378,31,17,PHI,1,34,59,93
2023_07_PIT_LA,LA,135,231,366,17,24,PIT,0,20,0,20
2023_07_PIT_LA,PIT,86,230,316,17,24,PIT,1,52,138,190
2023_07_SF_MIN,MIN,74,378,452,22,17,MIN,1,8,54,62
2023_07_SF_MIN,SF,65,272,337,22,17,MIN,0,15,58,73
2023_07_WAS_NYG,NYG,106,279,385,14,7,NYG,1,17,49,66
2023_07_WAS_NYG,WAS,76,249,325,14,7,NYG,0,22,70,92
2023_08_ATL_TEN,ATL,140,246,386,28,23,TEN,0,38,60,98
2023_08_ATL_TEN,TEN,149,238,387,28,23,TEN,1,54,50,104
2023_08_BAL_ARI,ARI,129,208,337,24,31,BAL,0,32,148,180
2023_08_BAL_ARI,BAL,130,157,287,24,31,BAL,1,80,5,85
2023_08_CHI_LAC,CHI,73,232,305,30,13,LAC,0,7,67,74
2023_08_CHI_LAC,LAC,54,298,352,30,13,LAC,1,17,44,61
2023_08_CIN_SF,CIN,134,283,417,17,31,CIN,1,36,61,97
2023_08_CIN_SF,SF,113,365,478,17,31,CIN,0,7,177,184
2023_08_CLE_SEA,CLE,155,257,412,24,20,SEA,0,56,9,65
2023_08_CLE_SEA,SEA,114,254,368,24,20,SEA,1,38,67,105
2023_08_HOU_CAR,CAR,44,235,279,15,13,CAR,1,23,55,78
2023_08_HOU_CAR,HOU,110,140,250,15,13,CAR,0,19,16,35
2023_08_JAX_PIT,JAX,106,292,398,10,20,JAX,1,18,75,93
2023_08_JAX_PIT,PIT,70,211,281,10,20,JAX,0,7,78,85
2023_08_KC_DEN,DEN,153,114,267,24,9,DEN,1,37,1,38
2023_08_KC_DEN,KC,62,240,302,24,9,DEN,0,7,51,58
2023_08_LA_DAL,DAL,102,307,409,43,20,DAL,1,3,57,60
2023_08_LA_DAL,LA,92,204,296,43,20,DAL,0,18,42,60
2023_08_LV_DET,DET,222,272,494,26,14,DET,1,56,16,72
2023_08_LV_DET,LV,80,126,206,26,14,DET,0,0,64,64
2023_08_MIN_GB,GB,74,229,303,10,24,MIN,0,24,89,113
2023_08_MIN_GB,MIN,62,297,359,10,24,MIN,1,13,55,68
2023_08_NE_MIA,MIA,78,324,402,31,17,MIA,1,24,51,75
2023_08_NE_MIA,NE,77,161,238,31,17,MIA,0,38,59,97
2023_08_NO_IND,IND,164,213,377,27,38,NO,0,0,86,86
2023_08_NO_IND,NO,161,354,515,27,38,NO,1,58,109,167
2023_08_NYJ_NYG,NYG,203,7,210,10,13,NYJ,0,48,0,48
2023_08_NYJ_NYG,NYJ,58,240,298,10,13,NYJ,1,26,94,120
2023_08_PHI_WAS,PHI,59,319,378,31,38,PHI,1,24,79,103
2023_08_PHI_WAS,WAS,84,397,481,31,38,PHI,0,26,118,144
2023_08_TB_BUF,BUF,115,324,439,24,18,BUF,1,15,44,59
2023_08_TB_BUF,TB,78,237,315,24,18,BUF,0,6,113,119
2023_09_ARI_CLE,ARI,41,58,99,27,0,CLE,0,4,31,35
2023_09_ARI_CLE,CLE,113,219,332,27,0,CLE,1,27,52,79
2023_09_BUF_CIN,BUF,68,258,326,24,18,CIN,0,32,62,94
2023_09_BUF_CIN,CIN,54,348,402,24,18,CIN,1,10,116,126
2023_09_CHI_NO,CHI,156,220,376,24,17,NO,0,1,19,20
2023_09_CHI_NO,NO,87,214,301,24,17,NO,1,45,41,86
2023_09_DAL_PHI,DAL,73,374,447,28,23,PHI,0,12,173,185
2023_09_DAL_PHI,PHI,109,207,316,28,23,PHI,1,11,3,14
2023_09_IND_CAR,CAR,138,173,311,13,27,IND,0,34,91,125
2023_09_IND_CAR,IND,78,127,205,13,27,IND,1,4,4,8
2023_09_LAC_NYJ,LAC,84,136,220,6,27,LAC,1,27,39,66
2023_09_LAC_NYJ,NYJ,64,263,327,6,27,LAC,0,7,102,109
2023_09_LA_GB,GB,184,228,412,20,3,GB,1,72,84,156
2023_09_LA_GB,LA,68,130,198,20,3,GB,0,0,31,31
2023_09_MIA_KC,KC,93,185,278,21,14,KC,1,13,14,27
2023_09_MIA_KC,MIA,117,193,310,21,14,KC,0,55,30,85
2023_09_MIN_ATL,ATL,110,268,378,28,31,MIN,0,73,57,130
2023_09_MIN_ATL,MIN,146,236,382,28,31,MIN,1,47,62,109
2023_09_NYG_LV,LV,125,209,334,30,6,LV,1,22,0,22
2023_09_NYG_LV,NYG,123,200,323,30,6,LV,0,14,104,118
2023_09_SEA_BAL,BAL,298,225,523,37,3,BAL,1,88,38,126
2023_09_SEA_BAL,SEA,28,157,185,37,3,BAL,0,-1,51,50
2023_09_TB_HOU,HOU,43,470,513,39,37,HOU,1,11,142,153
2023_09_TB_HOU,TB,81,265,346,39,37,HOU,0,24,135,159
2023_09_TEN_PIT,PIT,166,160,326,20,16,PIT,1,62,47,109
2023_09_TEN_PIT,TEN,105,262,367,20,16,PIT,0,16,92,108
2023_09_WAS_NE,NE,107,220,327,17,20,WAS,0,9,81,90
2023_09_WAS_NE,WAS,124,325,449,17,20,WAS,1,15,35,50
2023_10_ATL_ARI,ARI,122,249,371,25,23,ARI,1,40,41,81
2023_10_ATL_ARI,ATL,184,94,278,25,23,ARI,0,60,39,99
2023_10_CAR_CHI,CAR,43,185,228,16,13,CHI,0,5,81,86
2023_10_CAR_CHI,CHI,133,162,295,16,13,CHI,1,17,20,37
2023_10_CLE_BAL,BAL,106,223,329,31,33,CLE,0,29,11,40
2023_10_CLE_BAL,CLE,178,213,391,31,33,CLE,1,45,88,133
2023_10_DEN_BUF,BUF,192,177,369,22,24,DEN,0,81,20,101
2023_10_DEN_BUF,DEN,122,193,315,22,24,DEN,1,24,70,94
2023_10_DET_LAC,DET,200,333,533,38,41,DET,1,8,120,128
2023_10_DET_LAC,LAC,98,323,421,38,41,DET,0,15,59,74
2023_10_GB_PIT,GB,116,289,405,23,19,PIT,0,17,118,135
2023_10_GB_PIT,PIT,205,126,331,23,19,PIT,1,95,8,103
2023_10_HOU_CIN,CIN,66,347,413,27,30,HOU,0,15,156,171
2023_10_HOU_CIN,HOU,188,356,544,27,30,HOU,1,74,96,170
2023_10_IND_NE,IND,70,194,264,6,10,IND,1,18,46,64
2023_10_IND_NE,NE,167,195,362,6,10,IND,0,14,81,95
2023_10_NO_MIN,MIN,125,268,393,27,19,MIN,1,14,22,36
2023_10_NO_MIN,NO,65,232,297,27,19,MIN,0,3,88,91
2023_10_NYG_DAL,DAL,168,472,640,49,17,DAL,1,23,68,91
2023_10_NYG_DAL,NYG,111,86,197,49,17,DAL,0,18,44,62
2023_10_NYJ_LV,LV,148,153,301,16,12,LV,1,49,14,63
2023_10_NYJ_LV,NYJ,108,263,371,16,12,LV,0,1,139,140
2023_10_SF_JAX,JAX,59,190,249,3,34,SF,0,1,5,6
2023_10_SF_JAX,SF,144,302,446,3,34,SF,1,53,48,101
2023_10_TEN_TB,TB,77,278,355,20,6,TB,1,27,20,47
2023_10_TEN_TB,TEN,42,199,241,20,6,TB,0,-3,86,83
2023_10_WAS_SEA,SEA,120,369,489,29,26,SEA,1,25,113,138
2023_10_WAS_SEA,WAS,68,312,380,29,26,SEA,0,35,109,144
2023_11_ARI_HOU,ARI,123,214,337,21,16,HOU,0,15,86,101
2023_11_ARI_HOU,HOU,111,338,449,21,16,HOU,1,4,46,50
2023_11_CHI_DET,CHI,183,169,352,31,26,DET,0,69,0,69
2023_11_CHI_DET,DET,115,236,351,31,26,DET,1,32,120,152
2023_11_CIN_BAL,BAL,157,264,421,34,20,BAL,1,54,51,105
2023_11_CIN_BAL,CIN,136,169,305,34,20,BAL,0,52,35,87
2023_11_DAL_CAR,CAR,110,123,233,10,33,DAL,0,0,18,18
2023_11_DAL_CAR,DAL,107,204,311,10,33,DAL,1,51,27,78
2023_11_LAC_GB,GB,102,322,424,23,20,GB,1,14,64,78
2023_11_LAC_GB,LAC,150,260,410,23,20,GB,0,27,133,160
2023_11_LV_MIA,LV,36,271,307,20,13,MIA,0,0,151,151
2023_11_LV_MIA,MIA,99,325,424,20,13,MIA,1,22,12,34
2023_11_MIN_DEN,DEN,46,259,305,21,20,DEN,1,7,90,97
2023_11_MIN_DEN,MIN,175,221,396,21,20,DEN,0,42,42,84
2023_11_NYG_WAS,NYG,91,246,337,19,31,NYG,1,55,31,86
2023_11_NYG_WAS,WAS,174,256,430,19,31,NYG,0,29,106,135
2023_11_NYJ_BUF,BUF,130,275,405,32,6,BUF,1,56,2,58
2023_11_NYJ_BUF,NYJ,63,132,195,32,6,BUF,0,12,24,36
2023_11_PHI_KC,KC,168,177,345,17,21,PHI,0,6,61,67
2023_11_PHI_KC,PHI,114,150,264,17,21,PHI,1,11,81,92
2023_11_PIT_CLE,CLE,96,165,261,13,10,CLE,1,20,55,75
2023_11_PIT_CLE,PIT,172,106,278,13,10,CLE,0,41,53,94
2023_11_SEA_LA,LA,82,190,272,17,16,LA,1,36,108,144
2023_11_SEA_LA,SEA,68,236,304,17,16,LA,0,5,39,44
2023_11_TB_SF,SF,115,333,448,27,14,SF,1,32,18,50
2023_11_TB_SF,TB,66,246,312,27,14,SF,0,9,126,135
2023_11_TEN_JAX,JAX,128,262,390,34,14,JAX,1,30,29,59
2023_11_TEN_JAX,TEN,92,158,250,34,14,JAX,0,23,51,74
2023_12_BAL_LAC,BAL,197,177,374,10,20,BAL,1,73,28,101
2023_12_BAL_LAC,LAC,86,217,303,10,20,BAL,0,42,71,113
2023_12_BUF_PHI,BUF,173,339,512,37,34,PHI,0,44,45,89
2023_12_BUF_PHI,PHI,185,200,385,37,34,PHI,1,18,85,103
2023_12_CAR_TEN,CAR,96,194,290,17,10,TEN,0,26,55,81
2023_12_CAR_TEN,TEN,80,185,265,17,10,TEN,1,34,32,66
2023_12_CHI_MIN,CHI,118,217,335,10,12,CHI,1,30,62,92
2023_12_CHI_MIN,MIN,73,185,258,10,12,CHI,0,13,97,110
2023_12_CLE_DEN,CLE,107,190,297,29,12,DEN,0,3,56,59
2023_12_CLE_DEN,DEN,169,134,303,29,12,DEN,1,23,42,65
2023_12_GB_DET,DET,140,332,472,22,29,GB,0,19,164,183
2023_12_GB_DET,GB,109,268,377,22,29,GB,1,46,18,64
2023_12_JAX_HOU,HOU,91,304,395,21,24,JAX,0,31,114,145
2023_12_JAX_HOU,JAX,81,364,445,21,24,JAX,1,35,33,68
2023_12_KC_LV,KC,69,298,367,17,31,KC,1,14,81,95
2023_12_KC_LV,LV,123,248,371,17,31,KC,0,4,56,60
2023_12_LA_ARI,ARI,73,256,329,14,37,LA,0,18,126,144
2023_12_LA_ARI,LA,228,229,457,14,37,LA,1,52,9,61
2023_12_MIA_NYJ,MIA,167,243,410,13,34,MIA,1,73,0,73
2023_12_MIA_NYJ,NYJ,29,179,208,13,34,MIA,0,6,136,142
2023_12_NE_NYG,NE,147,143,290,10,7,NYG,0,45,9,54
2023_12_NE_NYG,NYG,58,191,249,10,7,NYG,1,10,25,35
2023_12_NO_ATL,ATL,228,168,396,24,15,ATL,1,80,73,153
2023_12_NO_ATL,NO,148,304,452,24,15,ATL,0,44,60,104
2023_12_PIT_CIN,CIN,25,227,252,10,16,PIT,0,0,68,68
2023_12_PIT_CIN,PIT,153,278,431,10,16,PIT,1,40,81,121
2023_12_SF_SEA,SEA,88,180,268,13,31,SF,0,15,57,72
2023_12_SF_SEA,SF,169,209,378,13,31,SF,1,47,58,105
2023_12_TB_IND,IND,155,251,406,27,20,IND,1,48,61,109
2023_12_TB_IND,TB,125,199,324,27,20,IND,0,44,87,131
2023_12_WAS_DAL,DAL,100,331,431,45,10,DAL,1,38,58,96
2023_12_WAS_DAL,WAS,108,300,408,45,10,DAL,0,33,88,121
2023_13_ARI_PIT,ARI,150,145,295,10,24,ARI,1,69,41,110
2023_13_ARI_PIT,PIT,130,187,317,10,24,ARI,0,10,65,75
2023_13_ATL_NYJ,ATL,90,121,211,8,13,ATL,1,20,10,30
2023_13_ATL_NYJ,NYJ,62,214,276,8,13,ATL,0,5,66,71
2023_13_CAR_TB,CAR,133,178,311,21,18,TB,0,26,55,81
2023_13_CAR_TB,TB,128,202,330,21,18,TB,1,75,14,89
2023_13_CIN_JAX,CIN,156,347,503,31,34,CIN,1,49,58,107
2023_13_CIN_JAX,JAX,71,321,392,31,34,CIN,0,9,96,105
2023_13_CLE_LA,CLE,87,254,341,36,19,LA,0,46,32,78
2023_13_CLE_LA,LA,120,279,399,36,19,LA,1,22,45,67
2023_13_DEN_HOU,DEN,118,186,304,22,17,HOU,0,38,87,125
2023_13_DEN_HOU,HOU,89,292,381,22,17,HOU,1,8,44,52
2023_13_DET_NO,DET,142,213,355,28,33,DET,1,28,22,50
2023_13_DET_NO,NO,113,267,380,28,33,DET,0,39,71,110
2023_13_IND_TEN,IND,55,312,367,28,31,IND,1,4,10,14
2023_13_IND_TEN,TEN,177,224,401,28,31,IND,0,23,85,108
2023_13_KC_GB,GB,129,267,396,27,19,GB,1,56,80,136
2023_13_KC_GB,KC,148,210,358,27,19,GB,0,12,38,50
2023_13_LAC_NE,LAC,29,212,241,0,6,LAC,1,7,59,66
2023_13_LAC_NE,NE,148,141,289,0,6,LAC,0,50,26,76
2023_13_MIA_WAS,MIA,123,283,406,15,45,MIA,1,68,8,76
2023_13_MIA_WAS,WAS,138,127,265,15,45,MIA,0,16,2,18
2023_13_SEA_DAL,DAL,136,299,435,41,35,DAL,1,64,50,114
2023_13_SEA_DAL,SEA,72,334,406,41,35,DAL,0,16,68,84
2023_13_SF_PHI,PHI,46,314,360,19,42,SF,0,10,118,128
2023_13_SF_PHI,SF,146,314,460,19,42,SF,1,31,76,107
2023_14_BUF_KC,BUF,118,233,351,17,20,BUF,1,16,50,66
2023_14_BUF_KC,KC,82,271,353,17,20,BUF,0,17,61,78
2023_14_CAR_NO,CAR,204,137,341,28,6,NO,0,30,52,82
2023_14_CAR_NO,NO,97,119,216,28,6,NO,1,6,82,88
2023_14_DEN_LAC,DEN,106,224,330,7,24,DEN,1,48,29,77
2023_14_DEN_LAC,LAC,76,275,351,7,24,DEN,0,12,131,143
2023_14_DET_CHI,CHI,142,223,365,28,13,CHI,1,32,15,47
2023_14_DET_CHI,DET,140,161,301,28,13,CHI,0,25,56,81
2023_14_GB_NYG,GB,123,218,341,24,22,NYG,0,26,96,122
2023_14_GB_NYG,NYG,209,158,367,24,22,NYG,1,61,59,120
2023_14_HOU_NYJ,HOU,81,95,176,30,6,NYJ,0,7,18,25
2023_14_HOU_NYJ,NYJ,79,301,380,30,6,NYJ,1,32,68,100
2023_14_IND_CIN,CIN,111,274,385,34,14,CIN,1,37,0,37
2023_14_IND_CIN,IND,46,240,286,34,14,CIN,0,13,99,112
2023_14_JAX_CLE,CLE,82,311,393,31,27,CLE,1,19,55,74
2023_14_JAX_CLE,JAX,58,257,315,31,27,CLE,0,22,115,137
2023_14_LA_BAL,BAL,139,316,455,37,31,BAL,1,23,104,127
2023_14_LA_BAL,LA,128,294,422,37,31,BAL,0,26,118,144
2023_14_MIN_LV,LV,56,171,227,0,3,MIN,0,13,35,48
2023_14_MIN_LV,MIN,132,146,278,0,3,MIN,1,27,83,110
2023_14_NE_PIT,NE,81,240,321,18,21,NE,1,31,20,51
2023_14_NE_PIT,PIT,82,190,272,18,21,NE,0,9,96,105
2023_14_PHI_DAL,DAL,138,271,409,33,13,DAL,1,23,65,88
2023_14_PHI_DAL,PHI,106,225,331,33,13,DAL,0,10,62,72
2023_14_SEA_SF,SEA,70,269,339,28,16,SF,0,17,54,71
2023_14_SEA_SF,SF,173,368,541,28,16,SF,1,28,113,141
2023_14_TB_ATL,ATL,96,347,443,25,29,TB,0,42,161,203
2023_14_TB_ATL,TB,148,144,292,25,29,TB,1,72,56,128
2023_14_TEN_MIA,MIA,158,240,398,27,28,TEN,0,38,86,124
2023_14_TEN_MIA,TEN,83,327,410,27,28,TEN,1,7,138,145
2023_15_ATL_CAR,ATL,52,152,204,9,7,CAR,0,9,27,36
2023_15_ATL_CAR,CAR,129,167,296,9,7,CAR,1,23,68,91
2023_15_BAL_JAX,BAL,251,171,422,7,23,BAL,1,113,4,117
2023_15_BAL_JAX,JAX,75,264,339,7,23,BAL,0,39,24,63
2023_15_CHI_CLE,CHI,88,166,254,20,17,CLE,0,14,45,59
2023_15_CHI_CLE,CLE,29,379,408,20,17,CLE,1,11,212,223
2023_15_DAL_BUF,BUF,266,94,360,31,10,BUF,1,57,17,74
2023_15_DAL_BUF,DAL,89,134,223,31,10,BUF,0,28,75,103
2023_15_DEN_DET,DEN,83,223,306,42,17,DET,0,41,66,107
2023_15_DEN_DET,DET,185,278,463,42,17,DET,1,61,34,95
2023_15_HOU_TEN,HOU,148,229,377,16,19,HOU,1,40,71,111
2023_15_HOU_TEN,TEN,66,199,265,16,19,HOU,0,26,38,64
2023_15_KC_NE,KC,43,309,352,17,27,KC,1,7,37,44
2023_15_KC_NE,NE,52,180,232,17,27,KC,0,28,17,45
2023_15_LAC_LV,LAC,92,257,349,63,21,LV,0,56,70,126
2023_15_LAC_LV,LV,124,260,384,63,21,LV,1,11,7,18
2023_15_MIN_CIN,CIN,80,324,404,27,24,CIN,1,21,140,161
2023_15_MIN_CIN,MIN,143,303,446,27,24,CIN,0,48,41,89
2023_15_NYG_NO,NO,87,218,305,24,6,NO,1,26,18,44
2023_15_NYG_NO,NYG,60,190,250,24,6,NO,0,8,104,112
2023_15_NYJ_MIA,MIA,77,228,305,30,0,MIA,1,34,3,37
2023_15_NYJ_MIA,NYJ,23,136,159,30,0,MIA,0,6,59,65
2023_15_PHI_SEA,PHI,178,143,321,20,17,SEA,0,50,25,75
2023_15_PHI_SEA,SEA,100,208,308,20,17,SEA,1,10,112,122
2023_15_PIT_IND,IND,170,215,385,30,13,IND,1,65,0,65
2023_15_PIT_IND,PIT,74,172,246,30,13,IND,0,13,42,55
2023_15_SF_ARI,ARI,234,211,445,29,45,SF,0,75,78,153
2023_15_SF_ARI,SF,144,262,406,29,45,SF,1,56,39,95
2023_15_TB_GB,GB,60,284,344,20,34,TB,0,15,89,104
2023_15_TB_GB,TB,99,381,480,20,34,TB,1,48,63,111
2023_15_WAS_LA,LA,196,258,454,28,20,LA,1,52,45,97
2023_15_WAS_LA,WAS,79,226,305,28,20,LA,0,7,124,131
2023_16_ARI_CHI,ARI,93,230,323,27,16,CHI,0,24,114,138
2023_16_ARI_CHI,CHI,250,170,420,27,16,CHI,1,84,12,96
2023_16_BAL_SF,BAL,102,252,354,19,33,BAL,1,29,2,31
2023_16_BAL_SF,SF,121,336,457,19,33,BAL,0,10,147,157
2023_16_BUF_LAC,BUF,105,237,342,22,24,BUF,1,27,51,78
2023_16_BUF_LAC,LAC,98,215,313,22,24,BUF,0,4,79,83
2023_16_CIN_PIT,CIN,59,335,394,34,11,PIT,0,29,28,57
2023_16_CIN_PIT,PIT,113,290,403,34,11,PIT,1,30,11,41
2023_16_CLE_HOU,CLE,54,374,428,22,36,CLE,1,10,36,46
2023_16_CLE_HOU,HOU,72,211,283,22,36,CLE,0,8,144,152
2023_16_DAL_MIA,DAL,97,253,350,22,20,MIA,0,45,62,107
2023_16_DAL_MIA,MIA,91,293,384,22,20,MIA,1,25,31,56
2023_16_DET_MIN,DET,143,257,400,24,30,DET,1,21,38,59
2023_16_DET_MIN,MIN,17,411,428,24,30,DET,0,2,146,148
2023_16_GB_CAR,CAR,96,312,408,30,33,GB,0,13,177,190
2023_16_GB_CAR,GB,162,219,381,30,33,GB,1,12,60,72
2023_16_IND_ATL,ATL,177,229,406,29,10,ATL,1,46,6,52
2023_16_IND_ATL,IND,92,201,293,29,10,ATL,0,14,82,96
2023_16_JAX_TB,JAX,37,305,342,30,12,TB,0,6,94,100
2023_16_JAX_TB,TB,70,283,353,30,12,TB,1,11,45,56
2023_16_LV_KC,KC,85,246,331,14,20,LV,0,19,117,136
2023_16_LV_KC,LV,157,62,219,14,20,LV,1,79,0,79
2023_16_NE_DEN,DEN,83,238,321,23,26,NE,0,14,154,168
2023_16_NE_DEN,NE,59,256,315,23,26,NE,1,13,41,54
2023_16_NO_LA,LA,133,328,461,30,22,LA,1,21,51,72
2023_16_NO_LA,NO,35,319,354,30,22,LA,0,7,103,110
2023_16_NYG_PHI,NYG,106,188,294,33,25,PHI,0,19,123,142
2023_16_NYG_PHI,PHI,170,301,471,33,25,PHI,1,84,77,161
2023_16_SEA_TEN,SEA,58,227,285,17,20,SEA,1,8,82,90
2023_16_SEA_TEN,TEN,162,164,326,17,20,SEA,0,21,79,100
2023_16_WAS_NYJ,NYJ,164,217,381,30,28,NYJ,1,10,63,73
2023_16_WAS_NYJ,WAS,102,156,258,30,28,NYJ,0,47,75,122
2023_17_ARI_PHI,ARI,221,232,453,31,35,ARI,1,50,68,118
2023_17_ARI_PHI,PHI,91,184,275,31,35,ARI,0,31,48,79
2023_17_ATL_CHI,ATL,134,180,314,37,17,CHI,0,53,27,80
2023_17_ATL_CHI,CHI,192,268,460,37,17,CHI,1,70,35,105
2023_17_CAR_JAX,CAR,57,112,169,26,0,JAX,0,3,59,62
2023_17_CAR_JAX,JAX,155,178,333,26,0,JAX,1,34,0,34
2023_17_CIN_KC,CIN,104,197,301,25,17,KC,0,2,46,48
2023_17_CIN_KC,KC,132,245,377,25,17,KC,1,30,14,44
2023_17_DET_DAL,DAL,61,345,406,20,19,DAL,1,25,95,120
2023_17_DET_DAL,DET,125,302,427,20,19,DAL,0,2,166,168
2023_17_GB_MIN,GB,177,293,470,10,33,GB,1,50,65,115
2023_17_GB_MIN,MIN,67,180,247,10,33,GB,0,7,52,59
2023_17_LAC_DEN,DEN,101,224,325,16,9,DEN,1,7,30,37
2023_17_LAC_DEN,LAC,86,220,306,16,9,DEN,0,10,70,80
2023_17_LA_NYG,LA,105,317,422,25,26,LA,1,55,37,92
2023_17_LA_NYG,NYG,105,319,424,25,26,LA,0,44,85,129
2023_17_LV_IND,IND,134,224,358,23,20,IND,1,74,4,78
2023_17_LV_IND,LV,84,299,383,23,20,IND,0,4,137,141
2023_17_MIA_BAL,BAL,160,340,500,56,19,BAL,1,67,49,116
2023_17_MIA_BAL,MIA,154,237,391,56,19,BAL,0,37,3,40
2023_17_NE_BUF,BUF,127,169,296,27,21,BUF,1,26,39,65
2023_17_NE_BUF,NE,103,209,312,27,21,BUF,0,25,60,85
2023_17_NO_TB,NO,108,208,316,13,23,NO,1,41,20,61
2023_17_NO_TB,TB,57,309,366,13,23,NO,0,0,220,220
2023_17_NYJ_CLE,CLE,127,309,436,37,20,CLE,1,43,6,49
2023_17_NYJ_CLE,NYJ,107,261,368,37,20,CLE,0,7,92,99
2023_17_PIT_SEA,PIT,202,274,476,23,30,PIT,1,39,77,116
2023_17_PIT_SEA,SEA,88,290,378,23,30,PIT,0,1,78,79
2023_17_SF_WAS,SF,184,230,414,10,27,SF,1,56,89,145
2023_17_SF_WAS,WAS,62,169,231,10,27,SF,0,2,15,17
2023_17_TEN_HOU,HOU,111,213,324,26,3,HOU,1,30,10,40
2023_17_TEN_HOU,TEN,53,184,237,26,3,HOU,0,14,38,52
2023_18_ATL_NO,ATL,78,318,396,48,17,NO,0,26,35,61
2023_18_ATL_NO,NO,154,264,418,48,17,NO,1,59,14,73
2023_18_BUF_MIA,BUF,128,359,487,14,21,BUF,1,26,83,109
2023_18_BUF_MIA,MIA,108,173,281,14,21,BUF,0,7,26,33
2023_18_CHI_GB,CHI,75,148,223,17,9,GB,0,13,54,67
2023_18_CHI_GB,GB,124,316,440,17,9,GB,1,20,106,126
2023_18_CLE_CIN,CIN,183,176,359,31,14,CIN,1,-2,17,15
2023_18_CLE_CIN,CLE,104,166,270,31,14,CIN,0,24,111,135
2023_18_DAL_WAS,DAL,131,309,440,10,38,DAL,1,14,73,87
2023_18_DAL_WAS,WAS,50,157,207,10,38,DAL,0,5,19,24
2023_18_DEN_LV,DEN,48,272,320,27,14,LV,0,4,111,115
2023_18_DEN_LV,LV,129,244,373,27,14,LV,1,27,76,103
2023_18_HOU_IND,HOU,60,264,324,19,23,HOU,1,-8,82,74
2023_18_HOU_IND,IND,227,141,368,19,23,HOU,0,25,38,63
2023_18_JAX_TEN,JAX,82,280,362,28,20,TEN,0,16,38,54
2023_18_JAX_TEN,TEN,175,168,343,28,20,TEN,1,3,42,45
2023_18_KC_LAC,KC,123,154,277,12,13,KC,1,67,8,75
2023_18_KC_LAC,LAC,118,258,376,12,13,KC,0,43,80,123
2023_18_LA_SF,LA,109,163,272,20,21,LA,1,36,25,61
2023_18_LA_SF,SF,125,189,314,20,21,LA,0,6,18,24
2023_18_MIN_DET,DET,70,320,390,30,20,DET,1,22,147,169
2023_18_MIN_DET,MIN,89,396,485,30,20,DET,0,8,116,124
2023_18_NYJ_NE,NE,88,88,176,3,17,NYJ,0,31,23,54
2023_18_NYJ_NE,NYJ,185,70,255,3,17,NYJ,1,74,19,93
2023_18_PHI_NYG,NYG,109,311,420,27,10,NYG,1,38,44,82
2023_18_PHI_NYG,PHI,133,203,336,27,10,NYG,0,10,94,104
2023_18_PIT_BAL,BAL,106,146,252,10,17,PIT,0,42,62,104
2023_18_PIT_BAL,PIT,155,152,307,10,17,PIT,1,25,74,99
2023_18_SEA_ARI,ARI,206,262,468,20,21,SEA,0,48,97,145
2023_18_SEA_ARI,SEA,138,189,327,20,21,SEA,1,0,70,70
2023_18_TB_CAR,CAR,131,94,225,0,9,TB,0,38,9,47
2023_18_TB_CAR,TB,113,137,250,0,9,TB,1,63,24,87
2023_19_CLE_HOU,CLE,56,307,363,45,14,HOU,0,25,38,63
2023_19_CLE_HOU,HOU,76,280,356,45,14,HOU,1,19,17,36
2023_19_GB_DAL,DAL,123,403,526,32,48,GB,0,16,210,226
2023_19_GB_DAL,GB,143,272,415,32,48,GB,1,45,3,48
2023_19_LA_DET,DET,79,277,356,24,23,DET,1,7,22,29
2023_19_LA_DET,LA,68,367,435,24,23,DET,0,36,101,137
2023_19_MIA_KC,KC,147,262,409,26,7,KC,1,31,33,64
2023_19_MIA_KC,MIA,76,199,275,26,7,KC,0,14,99,113
2023_19_PHI_TB,PHI,42,250,292,32,9,TB,0,6,59,65
2023_19_PHI_TB,TB,119,337,456,32,9,TB,1,21,78,99
2023_19_PIT_BUF,BUF,179,203,382,31,17,BUF,1,51,22,73
2023_19_PIT_BUF,PIT,106,229,335,31,17,BUF,0,26,68,94
2023_20_GB_SF,GB,136,194,330,24,21,SF,0,62,19,81
2023_20_GB_SF,SF,111,252,363,24,21,SF,1,35,68,103
2023_20_HOU_BAL,BAL,229,152,381,34,10,BAL,1,84,26,110
2023_20_HOU_BAL,HOU,38,175,213,34,10,BAL,0,7,34,41
2023_20_KC_BUF,BUF,170,186,356,24,27,KC,0,14,44,58
2023_20_KC_BUF,KC,146,215,361,24,27,KC,1,40,16,56
2023_20_TB_DET,DET,114,287,401,31,23,DET,1,55,131,186
2023_20_TB_DET,TB,89,349,438,31,23,DET,0,0,90,90
2023_21_DET_SF,DET,182,273,455,34,31,SF,0,14,106,120
2023_21_DET_SF,SF,155,267,422,34,31,SF,1,73,48,121
2023_21_KC_BAL,BAL,81,272,353,10,17,KC,0,20,97,117
2023_21_KC_BAL,KC,89,241,330,10,17,KC,1,13,52,65
2023_22_SF_KC,KC,130,333,463,25,22,KC,1,24,112,136
2023_22_SF_KC,SF,110,276,386,25,22,KC,0,24,57,81
